#################################
#@--------####------######-----##
#-######--####--##--######--##--#
#-#----#---------#-------#--##-##
#-#-##-#####-##########-#--###--#
#-#-##-#####-##########-#----##-#
#-#----------###--------###--##-#
#-############-########-##--##--#
#----#######---######$---##--#-##
#-##-######-#####--#####-----#--#
#-##--------###--------###--#--##
###-###############-######--#-###
##------###########---------#.###
#################################