########################################
#---##---#---#----##$--##---#---#----###
#-#---##-#-#---##-##-#---##-#-#---##-###
#-###-##---####---##-###-##---####---###
###---######----#-####---######----#-###
#---########-####-##---########-####-###
#-##-#---###--#---##-##-#---###--#---###
#----#-#--###---#-##----#-#--###---#-###
##-###--#---#-###-###-###--#---#-###-###
#--####-###-#-#---##--####-###-#-#---###
#-#---#-##----#-####-#---#-##----#-#####
#---#---###-###---##---#---###-###---###
#-#####---#######-##-#####---#######-###
#########-####----##########-####----###
#######---#######---#####----#######---#
##----#-#######---#-------#-######---#-#
##@##-----####--###-#-##-----####--###-#
##################################.#####