#####################
#$--##---#---#----###
#-#---##-#-#---##-###
#-###-##---####---###
###---######----#-###
#---########-####-###
#-##-#---###--#---###
#----#-#--###---#-###
##-###--#---#-###-###
#--####-###-#-#---###
#-#---#-##----#-#####
#---#---###-###---###
#-#####---#######-###
#########-####----###
#######---#######---#
##----#-#######---#-#
##@##-----####--###-#
##############.######